# # # # # # # # # # #
# S . . # . . . . . #
# # # . # . # # # . #
# . . . . . . . . . #
# . # # # # # . # # #
# . . . . . # . . . #
# # # # # . # # . # #
# . . . . . . . . . #
# . # # # # # # . # #
# . . . . . . . . G #
# # # # # # # # # # #