S . . . . . . . . .
# # # # # # # # # .
. . . . . . . . # .
. # . # # # # . # .
. # . . . . # . # .
. # . # # . # . # .
. # . # G . # . # .
. # . # # # # . # .
. . . . . . . . . .
. # # # # # # # # #