S . # . . # . . # .
# . # # . # . # . #
. . . . . . . . # .
. . # . # # . # . .
. . . . . . . . . #
# . . # . . # # . .
. # . # G . . # . .
. . . . . # . . . #
# # . # . . # # . .
. . . # . . . # . .


